111111
1P0001
000001
010101
010001
011101
000000
111111