111111
0P0000
000000
000000
000000
000000
