111111
0P0000
000000
010000
000010
010000
