111111111111
1P0000001001
000000001001
010100000001
010000000000
011100010001
000000000001
111111000000